%%%%%%%%%%%%%%%%%%%%%%%%%%%%%%%%%%%%%%%%%%%%%%%%%%%%%%%%%%%%%%%%%%%%%%%%%%%%%%%%%%%%%%%%%%%%%%%%%%%%%
%    %     %              %  %  %     %           %     %              %        %  %                %
%%%  %%%%  %  %%%%  %  %%%%  %  %%%%  %%%%%%%  %  %%%%  %%%%%%%%%%  %%%%  %  %  %  %%%%  %  %%%%%%%%%
%    %     %  %     %     %  %  %     %     %  %     %        %     %     %  %  %     %  %  %       %
% %  %  %%%%%%%  %  %%%%%%%  %  %%%%  %%%%  %%%%%%%  %%%%%%%  %  %%%%%%%  %%%%%%%%%%  %%%%  %  %  %%%
% %  %     %  %  %                 %              %  %              %                    %  %  %    %
% %  %  %%%%  %  %  %  %%%%  %%%%%%%%%%%%%%%%%%%  %  %%%%%%%  %%%%%%%  %%%%  %%%%  %  %%%%  %  %%%% %
% %  %  %     %  %  %     %  %  %  %  %  %  %        %        %           %  %     %  %     %  %  % %
%%   %  %  %  %%%%  %%%%%%%  %  %  %  %  %  %%%%  %%%%  %%%%%%%%%%  %%%%  %%%%%%%  %%%%  %  %%%%  % %
% %        %     %  %                    %              %           %        %  %     %  %          %
% %%%%%%%  %%%%%%%%%%%%%%%%%%%%%%%%%%%%  %%%%  %  %%%%%%%%%%  %%%%  %%%%%%%  %  %  %%%%%%%%%%%%%  %%%
%    %     %     %     %  %  %        %  %     %                 %  %     %  %  %     %        %    %
% %  %  %  %  %  %%%%  %  %  %%%%  %%%%  %  %%%%  %  %%%%%%%  %%%%  %%%%  %  %  %  %%%%%%%%%%  %  %%%
% %  %  %  %  %           %              %  %     %  %     %     %        %     %  %     %  %       %
%%%  %  %%%%  %  %  %%%%  %%%%  %%%%  %  %%%%  %  %%%%%%%  %%%%  %  %%%%%%%  %%%%%%%%%%  %  %%%%  %%%
%       %     %  %  %     %     %     %  %  %  %     %        %  %     %     %     %              % %
%%%%%%  %  %%%%  %  %%%%  %%%%%%%  %  %  %  %  %%%%%%%  %%%%  %%%%%%%  %%%%  %  %%%%  %%%%  %%%%  % %
%       %     %  %  %        %     %  %     %        %  %        %  %  %     %     %     %  %       %
% %  %%%%  %%%%  %%%%%%%  %  %%%%  %%%%%%%  %  %%%%  %  %  %%%%  %  %  %%%%%%%  %%%%%%%  %%%%%%%%%% %
% %        %     %        %           %           %     %  %  %     %  %           %  %     %  %  % %
%%%  %%%%%%%  %%%%  %%%%%%%%%%  %%%%%%%  %%%%  %%%%%%%%%%  %  %  %  %  %%%%%%%  %%%%  %  %  %  %  % %
% %  %     %     %        %  %  %     %     %     %     %     %  %  %  %  %  %           %  %  %  % %
% %  %  %%%%%%%  %  %%%%%%%  %%%%  %  %%%%  %  %  %%%%  %  %  %%%%  %%%%  %  %%%%%%%  %%%%  %  %  %%%
%             %  %  %  %  %     %  %        %  %  %     %  %  %     %        %  %     %        %  % %
%%%%%%  %%%%  %%%%  %  %  %%%%  %%%%%%%%%%%%%  %%%%  %  %  %  %%%%%%%  %  %  %  %%%%%%%  %  %%%%  % %
%          %  %        %           %  %  %  %     %  %  %  %  %     %  %  %  %        %  %  %       %
%%%  %%%%  %  %  %  %%%%%%%  %  %  %  %  %  %  %%%%  %%%%  %%%%  %%%%  %%%%  %%%%  %  %  %  %%%%  % %
% %     %  %  %  %     %  %  %  %     %              %  %  %     %  %  %  %  %     %     %        % %
% %%%%%%%%%%%%%%%%%%%  %  %%%%%%%  %%%%%%%%%%%%%  %  %  %%%%  %%%%  %  %  %  %  %  %  %%%%%%%  %%%% %
%                   %  %  %     %  %     %     %  %     %  %           %  %     %  %     %     %  % %
% %  %  %%%%%%%%%%  %%%%  %%%%  %  %%%%  %%%%  %  %  %%%%  %%%%  %  %  %  %%%%%%%  %%%%%%%%%%%%%  % %
%    %     %           %                       %  %              %  %  %        %  %  %  %     %    %
% %%%%%%%%%%%%%%%%  %%%%%%%%%%  %  %%%%  %%%%  %%%%  %%%%%%%%%%%%%%%%  %%%%  %%%%%%%  %  %  %  %%%% %
%    %  %        %  %        %  %  %        %     %     %  %  %     %              %  %     %     % %
% %  %  %%%%  %  %  %%%%  %%%%  %  %%%%%%%%%%  %%%%  %%%%  %  %  %%%%%%%  %%%%  %%%%  %  %  %%%%%%% %
% %        %  %        %  %     %  %                 %  %     %              %     %     %     %    %
%%%%%%  %%%%%%%  %%%%%%%  %  %%%%%%%%%%  %%%%%%%%%%  %  %  %%%%  %  %  %%%%%%%  %  %  %%%%%%%%%%%%%%%
%             %        %              %        %     %     %     %  %  %     %  %  %  %     %  %  % %
%%%  %%%%%%%  %%%%%%%  %%%%%%%%%%  %%%%  %%%%  %  %%%%  %%%%%%%%%%%%%  %  %%%%%%%%%%  %%%%  %  %  % %
%       %     %        %  %        %     %     %        %     %     %     %           %     %     % %
% %%%%%%%  %  %%%%%%%%%%  %%%%  %  %  %  %  %%%%%%%  %%%%  %  %%%%  %  %%%%%%%  %%%%  %  %  %  %  % %
% %     %  %  %           %     %  %  %  %     %           %  %              %  %  %  %  %     %    %
% %  %  %  %%%%  %%%%  %%%%%%%  %%%%  %%%%%%%%%%%%%  %%%%  %%%%  %%%%  %%%%%%%  %  %  %  %%%%%%%%%% %
% %  %  %  %  %  %  %     %        %     %        %     %     %     %     %     %     %     %       %
% %  %%%%%%%  %%%%  %  %%%%%%%  %%%%  %  %%%%  %%%%  %%%%  %%%%  %  %%%%%%%  %%%%%%%  %  %  %  %  % %
%             %     %     %     %     %     %     %  %        %  %  %     %  %  %  %  %  %  %  %  % %
%%%  %  %%%%%%%  %  %  %  %  %%%%%%%%%%%%%  %  %%%%%%%%%%  %  %%%%%%%  %%%%%%%  %  %  %  %  %%%%  %%%
%    %  %        %  %  %     %     %     %        %  %  %  %     %        %  %           %     %    %
% %%%%%%%%%%  %%%%%%%%%%%%%  %  %%%%  %%%%%%%  %%%%  %  %%%%%%%%%%  %%%%  %  %%%%%%%  %  %%%%%%%%%%%%
% %     %        %           %     %        %  %           %           %  %     %     %  %          %
% %  %  %  %%%%%%%%%%%%%  %%%%%%%  %  %%%%%%%  %%%%%%%  %%%%%%%  %  %  %  %%%%  %  %  %%%%%%%  %%%%%%
%    %  %     %     %     %        %  %                 %  %     %  %  %     %     %  %        %    %
% %%%%  %  %%%%  %%%%  %%%%  %%%%  %  %%%%  %%%%  %%%%  %  %%%%%%%%%%  %  %  %  %%%%%%%  %  %  %  %%%
% %        %     %     %  %  %                 %  %     %           %  %  %     %  %  %  %  %  %    %
%%%%%%  %%%%  %%%%  %%%%  %%%%%%%%%%  %%%%  %%%%  %%%%  %%%%  %  %%%%%%%%%%  %%%%  %  %%%%  %%%%%%% %
% %        %     %           %  %     %     %  %  %     %     %  %        %     %        %          %
% %  %%%%  %  %%%%%%%%%%  %%%%  %%%%  %%%%%%%  %%%%%%%%%%%%%  %  %%%%  %%%%%%%  %%%%  %  %  %%%%%%%%%
% %  %        %     %  %        %  %  %     %  %     %  %     %        %        %     %  %     %    %
% %  %%%%%%%  %  %%%%  %  %%%%  %  %%%%  %%%%  %%%%  %  %  %%%%  %  %  %  %%%%  %%%%%%%  %%%%  %%%%%%
%          %     %        %     %              %     %        %  %  %     %     %           %     % %
% %%%%%%%  %%%%%%%%%%%%%%%%%%%%%%  %%%%%%%%%%%%%%%%  %%%%%%%%%%  %  %  %%%%%%%%%%%%%%%%  %%%%  %  % %
%       %  %        %  %           %     %        %     %  %  %  %  %  %  %        %           %    %
%%%  %%%%  %%%%  %%%%  %  %%%%%%%%%%  %  %  %  %%%%  %%%%  %  %%%%%%%  %  %%%%  %%%%  %%%%%%%%%%  %%%
% %     %  %  %                       %     %        %                 %              %           % %
% %  %  %  %  %  %  %%%%  %%%%  %%%%%%%%%%%%%%%%%%%%%%%%%  %%%%  %  %  %%%%%%%  %%%%%%%%%%%%%  %%%% %
%    %  %        %  %  %  %     %  %           %  %        %     %  %  %           %     %  %  %    %
% %  %%%%  %%%%%%%%%%  %  %%%%%%%  %  %  %  %%%%  %  %%%%%%%%%%  %%%%  %%%%  %%%%%%%%%%  %  %%%%%%% %
% %  %  %  %  %        %     %     %  %  %  %              %  %  %     %  %  %     %        %     % %
%%%  %  %%%%  %%%%  %%%%%%%  %%%%  %  %%%%%%%  %  %  %%%%  %  %%%%  %%%%  %  %  %  %  %%%%  %  %  % %
% %  %  %     %                 %        %  %  %  %     %  %     %           %  %  %  %        %  % %
% %  %  %%%%  %  %  %%%%  %%%%  %%%%  %%%%  %  %  %  %%%%  %%%%  %  %  %%%%  %  %  %  %%%%  %%%%%%% %
% %        %     %  %     %  %           %  %  %  %  %  %        %  %     %  %  %     %  %     %    %
% %  %  %%%%  %%%%  %%%%%%%  %  %%%%%%%%%%  %%%%%%%  %  %%%%%%%%%%%%%%%%%%%  %  %%%%  %  %%%%%%%%%% %
%    %     %     %     %           %        %  %     %     %              %     %     %             %
% %%%%  %%%%  %%%%  %%%%  %%%%%%%%%%%%%  %  %  %  %%%%%%%  %  %%%%%%%  %%%%  %%%%  %  %  %%%%%%%  % %
% %     %  %  %        %                 %  %              %  %           %  %     %  %  %        % %
% %%%%%%%  %%%%  %%%%%%%  %  %  %  %  %  %%%%  %%%%%%%%%%  %%%%%%%%%%  %%%%%%%  %%%%  %%%%%%%  %%%%%%
%      %           %  %  %  %  %  %  %        %  %  %  %     %  %           %  %  %     %        % %
% %%%%%%%%%%%%%%%%%%%  %  %%%%%%%  %%%%  %  %%%%  %  %  %  %  %  %  %%%%  %  %  %  %  %%%%%%%%%%%%% %
% %                 %     %           %  %          P   %  %           %  %  %  %     %  %        % %
% %%%%%%%  %  %%%%  %%%%  %%%%%%%%%%%%%  %%%%%%%%%%  %%%%%%%  %  %%%%  %%%%%%%%%%%%%%%%  %  %  %%%% %
% %        %  %     %     %           %  %     %           %  %  %        %        %        %     % %
% %  %%%%  %%%%  %%%%  %  %%%%  %  %%%%%%%  %%%%%%%%%%  %%%%%%%%%%  %%%%  %  %%%%%%%  %%%%%%%  %%%% %
% %  %  %     %  %  %  %     %  %  %     %                    %     %     %              %        % %
%%%%%%  %  %%%%%%%  %  %%%%  %  %%%%%%%  %  %%%%  %%%%  %%%%  %  %  %%%%%%%%%%  %%%%  %%%%  %%%%  %%%
% %  %     %  %  %  %  %        %        %  %     %  %  %     %  %  %           %     %     %       %
% %  %  %%%%  %  %  %%%%  %%%%%%%  %%%%%%%  %%%%%%%  %  %  %%%%  %%%%%%%%%%%%%%%%%%%%%%  %  %%%%  % %
% %  %     %           %     %  %              %     %  %     %     %  %  %           %  %  %     % %
% %  %%%%  %  %  %%%%  %  %  %  %%%%  %%%%%%%  %  %  %  %%%%%%%%%%  %  %  %  %%%%%%%%%%  %%%%%%%%%% %
%    %  %  %  %  %        %        %  %     %  %  %     %     %  %     %     %     %           %    %
% %  %  %  %%%%%%%  %%%%%%%%%%  %%%%%%%  %  %%%%  %%%%  %  %  %  %  %  %  %%%%  %  %%%%%%%  %%%%%%%%%
% %     %                    %        %  %  %        %     %  %     %  %     %  %        %  %       %
%%%  %%%%%%%%%%%%%%%%  %%%%  %  %  %  %%%%  %  %  %%%%  %%%%%%%%%%  %%%%  %  %  %  %%%%%%%%%%%%%%%% %
% %     %  %              %  %  %  %  %        %  %     %     %  %     %  %     %  %  %  %  %       %
% %  %  %  %%%%%%%%%%  %  %  %%%%%%%%%%%%%%%%%%%  %%%%%%%%%%  %  %%%%  %  %%%%%%%%%%  %  %  %%%%%%% %
%    %     %           %  %  %     %  %     %  %  %  %  %     %           %  %              %       %
%%%  %%%%  %  %  %%%%%%%  %%%%%%%  %  %  %%%%  %  %  %  %%%%  %%%%%%%  %%%%  %%%%  %%%%%%%%%%%%%%%% %
% %  %        %  %              %  %  %        %        %     %     %  %  %              %          %
%% %%%%  %%%%%%%  %  %%%%  %%%%%%%  %  %  %%%%  %%%%  %  %  %%%%%%%  %%%%  %  %%%%%%%%%%  %  %  %%%%%
%%%%%%%%%%%%%%%%%%%%%%%%%%%%%%%%%%%%%%%%%%%%%%%%%%%%%%%%%%%%%%%%%%%%%%%%%%%%%%%%%%%%%%%%%%%%%%%%%%%%%