%%%%%%%%%%%%%%%%%%%%%%%%%%%%%%%%%%%%%%%%%%%%%%%%%%%%%%%%%%%%%%%%%%%%%%%%%%
%       % % %     .     %   %     % %%       % % %     .     %   %     % %
% %%%%%%% % %%% % %%% %%% %%%%%%% % %% %%%%%%% % %%% % %%% %%% %%%%%%% % %
%       %       % %     %     % %   %%       %       % %     %     % %   %
%%%%% %%%%% %%% % % % %%% %%%%% % %%%%%%%% %%%%% %%% % % % %%% %%%%% % %%%
%   % % % %   % % % %   % %   % %        % % % %   % % % %   % %   % %   %
% %%% % % % %%% %%%%% %%% % %%% %%% %% %%% % % % %%% % %%% %%% % %%% %%% %
%   .   %     %   %   %     % % %   %%   .             %   %     % % %   %
%%% %%%%%%%%% %%%%%%% %%% %%% % % % %%%% %%%%%%%%% %%%%%%% %%% %%% % % % %
%             %       % %   %     % %%             %       % %   %     % %
% % %%%%% % %%% % % %%% % %%% %%% % %% % %%%%% % %%% % % %%% % %%% %%% % %
% % %     % % % % %     %   % % % % %% % %     % % % % %     %   % % % % %
% % % %%%%%%% % %%%%%%%%% %%% % %%% %% % % %%%%%%% % %%%%%%%%% %%% % %%% %
% % % %     %   %     %     %   %   %% % % %     %   %     %     %   %   %
%%% %%% % %%%%% %%%%% %%% %%% %%%%% %%%% %%% % %%%%% %%%%% %%% %%% %%%%% %
%     % % %     % %     % %   % % % %%     % % %     % %     % %   % % % %
% % % % % %%% %%% %%% %%% % % % % % %% % % % % %%% %%% %%% %%% % % % % % %
% % % % %                 % % %     %% % % % %                 % % %     %
%%% %%%%%%% % % %%%%% %%% % %%% %%%%%%%% %%%%%%% % % %%%%% %%% % %%% %%%%%
%       % % % %     %   %     % %            % % % %     %   %     % %   %
%%%%% % % %%%%%%%%% %%%%%%%%%%% % %%%%%%%% % % %%%%%%%%% %%%%%%%%%%% % %%%
%   % %           % %     %   % %   %%   % %           % %     %   % %   %
% %%% %%%%% %%%%%%%%% %%%%% % % %%% %% %%% %%%%% %%%%%%%%% %%%%% % % %%% %
% %   %      %        %     %       %% %   %      %        %     %       %
% % % %%%%% %%% % % % % %%%%%%%%%%%%%% % % %%%%% %%% % % % % %%%%%%%%%%%%%
% % %   %     % % % %       %   % % %% % %         % % % %       %   % % %
% % %%% %%% % % % %%%%%%%%% %%% % %    % %%% %%% % % % %%%%%%%%% %%% % % %
% %     %   % % %   % %   % % %     %% %   % %   % % %   % %   % % %     %
% %%% %%% %%%%% %%% % % %%%%% % %%%%%% %%% %%% %%%%% %%% % % %%%%% % %%%%%
%       %   %     % %     %   % %   %%       %   %     % %     %   % %   %
%%% % %%%%% %%%%% %%% %%% % %%% % %%%%%% % %%%%% %%%%% %%% %%% % %%% % %%%
% % % % % % % %     % %   % %   % % %% % % % % % % %     % %   % %   % % %
% % %%% % % % % %%%%%%%%% % % % % % %% % %%% % % % % %%%%%%%%% % % % % % %
%       %   %                 %     %%   %   %                     %     %
% % % % %%% %%% %%%%%%% %%% %%% %%% %% % % % %%% %%% %%%%%%% %%% %%% %%% %
%.  % %       %   %       %   % %   %%.% % %       %   %       %   % %  P%
%%%%% %%%%%%%%% %%%% %%%%%%%%%%%%%%%%%%%%%%%%%%%%%%%% %%%%%%%%%%%%%%%%%%%%
%%%%% %%%%%%%%% %%%% %%%%%%%%%%%%%%%%%%%%%%%%%%%%%%%  %%%%%%%%%%%%%%%%%%%%
%       % % %     .     %   %     % %%       % % %     .     %   %     % %
% %%%%%%% % %%% % %%% %%% %%%%%%% % %% %%%%%%% % %%% % %%% %%% %%%%%%% % %
%       %       % %     %           %%               % %     %     % %   %
%%%%% %%%%% %%% % % % %%% %%%%% % %%%%%%%% %%% % %%% % % % %%% %%%%% % %%%
%   % % % %   % % % %   % %   % %          % % %   %   % %   % %   % %   %
% %%% % % % %%% %%%%% %%% % %%% %%% %% %%% % % % %%% %%%%% %%% % %%% %%% %
%   .   %     %   %   %     % % %   %%   .   %         %   %     % % %   %
%%% %%%%%%%%% %%%%%%% %%% %%% % % % %%%% %%%%%%%%% %%%%%%% %%% %%% % % % %
%                       %   %     % %%             %       % %   %     % %
% % %%%%% % %%% % % %%% % %%% %%% % %% % %%%%% % %%% % % %%% % %%% %%% % %
% % %     % % % % %     %   % % % % %% % %     % % % % %     %   % % % % %
% % % %%%%%%% % %%%%%%% % %%% % %%% %% % % %%%%%%% % %%%%%%%%% %%% % %%% %
% % % %     %   %     %     %   %      % % %     %   %     %     %   %   %
%%% %%% % %%%%% %%%%% %%% %%% %%%%% %%%% %%% % %%%%% %%%%% %%% %%% %%%%% %
%     % % %     % %     % %   % % %        % % %     % %     % %   % % % %
% % % % % %%% %%% %%% %%% % % % % % %% % % % % %%% %%% %%% %%% % % % % % %
% % % % %                 % % %     %% % % % %                 % % %     %
%%% %%%%%%% % % %%%%% %%% % %%% %%%%%%%% %%%%%%% % % %%%%% %%% % %%% %%%%%
%       % % % %     %   %     % %   %%       % % % %     %   %     % %   %
%%%%% % % %%%%%%%%% %%%%%%%%%%% % %%%%%%%% % % %%%%%%%%% %%%%%%%%%%% % %%%
%   % %           % %     %   % %   %%   % %           % %     %   % %   %
% %%% %%%%% %%%%%%%%% %%%%% % % %%% %% %%% %%%%% %%%%%%%%% %%%%% % % %%% %
% %   %      %        %     %       %% %   %      %        %     %       %
% % % %%%%% %%% % % % % %%%%%%%%%%%%%% % % %%%%% %%% % % % % %%%%%%%%%%%%%
% % %   %     % % % %       %   % % %% % %   %     % % % %       %   % % %
% % %%% %%% % % % %%%%%%%%% %%% % %    % %%% %%% % % % %%%%%%%%% %%% % % %
% %   % %   % % %   % %   % % %     %% %   % %   % % %   % %   % % %     %
% %%% %%% %%%%% %%% % % %%%%% % %%%%%% %%% %%% %%%%% %%% % % %%%%% % %%%%%
%       %   %     % %     %   % %   %%       %   %     % %     %   % %   %
%%% % % %%% %%%%% %%% %%% % %%% % %%%%%% % %%%%% %%%%% %%% %%% % %%% % %%%
% % % % % % % %     % %   % %   % % %% % % % % % % %     % %   % %   % % %
% % %%% % % % % %%%%%%%%% % % % % % %% % %%% % % % % %%%%%%%%% % % % % % %
%   %   %                           %%   %   %   %                 %     %
% % % % %%% %%% %%%%%%% %%% %%% %%%    % % % %%% %%% %%%%%%% %%% %%% %%% %
%.% % %       %   %       %   % %   %%.% % %       %   %       %   % %   %
%%%%%%%%%%%%%%%%%%%%%%%%%%%%%%%%%%%%%%%%%%%%%%%%%%%%%%%%%%%%%%%%%%%%%%%%%%