%%%%%%%
%.   P%
% %%% %
%  %  %
%%   %%
%. %%%%
%%%%%%%
